0133:      { 000 7 ---  010 7 ---  001 7 ---  011 7 --- }

0134:      { 002 7 ---  012 7 ---  003 7 ---  013 7 --- }

0135:      { 020 7 ---  020 7 ---  021 7 ---  021 7 --- }

0136:      { 022 7 ---  022 7 ---  023 7 ---  023 7 --- }

0137:      { 000 7 ---  010 7 ---  001 7 ---  011 7 --- }

0138:      { 002 7 ---  012 7 ---  003 7 ---  013 7 --- }

0139:      { 000 7 ---  010 7 ---  001 7 ---  011 7 --- }

013A:      { 002 7 ---  012 7 ---  003 7 ---  013 7 --- }
