0133:      { 000 6 ---  010 6 ---  001 6 ---  011 6 --- }

0134:      { 002 6 ---  012 6 ---  003 6 ---  013 6 --- }

0135:      { 020 6 ---  020 6 ---  021 6 ---  021 6 --- }

0136:      { 022 6 ---  022 6 ---  023 6 ---  023 6 --- }

0137:      { 000 6 ---  010 6 ---  001 6 ---  011 6 --- }

0138:      { 002 6 ---  012 6 ---  003 6 ---  013 6 --- }

0139:      { 000 6 ---  010 6 ---  001 6 ---  011 6 --- }

013A:      { 002 6 ---  012 6 ---  003 6 ---  013 6 --- }
